border_size=1
usage=map

Wo          , Wo          , Wo          , Wo          , Wo          , Wo          , Wo          , Wo          , Wo          , Wo          , Wo          , Wo          , Wo          , Wo          , Gg          , Wo          , Wo          , Wo          , Gs^Fmw      , Gs^Fmw      , Gs^Fdw      , Sm^Gvs      , Sm^Gvs      , Sm^Gvs      , Sm^Gvs      , Sm^Gvs      , Sm^Gvs      , Gs^Vht      , Gs^Fms      , Gs          , Re          , Gs          , Gs          , Gs          , Gs^Fmw      , Gs^Fmw      , Gs^Fmw      
Wo          , Wo          , Wo          , Wo          , Wo          , Wo          , Wo          , Wo          , Wo          , Wo          , Ww          , Ww          , Ds          , Wo          , Wo          , Wo          , Wo          , Gs^Fms      , Gs^Fmw      , Ss          , Gs^Fms      , Sm^Gvs      , Sm^Gvs      , Sm^Gvs      , Sm^Gvs      , Sm^Gvs      , Sm^Gvs      , Gs^Fmw      , Gs^Fms      , Gs          , Re          , Gs          , Gg          , Gg          , Gg          , Gs^Fms      , Gs^Fms      
Wo          , Wo          , Wo          , Wo          , Wo          , Wo          , Wo          , Wo          , Wo          , Wo          , Ww          , Ww          , Ww          , Ds          , Wo          , Wo          , Wo          , Gd^Fmw      , Gs^Fms      , Gs^Fmw      , Gs^Fms      , Sm^Gvs      , Sm^Gvs      , Sm^Gvs      , Sm^Gvs      , Sm^Gvs      , Sm^Gvs      , Gs^Fms      , Gs          , Gs          , Re          , Gs          , Gg          , Gs          , Gs          , Gs          , Gs          
Wo          , Wo          , Wo          , Wo          , Wo          , Wo          , Wo          , Wo          , Wo          , Wo          , Ww          , Ww          , Ww          , Ww          , Wo          , Wo          , Gs^Fms      , Gd^Fmw      , Gs^Fp       , Ss          , Gs^Fp       , Gs^Fms      , Gs^Fms      , Sm^Gvs      , Sm^Gvs      , Sm^Gvs      , Sm^Gvs      , Gs          , Re          , Re          , Gs          , Re          , Gs          , Gs          , Ss          , Ss          , Ss          
Wo          , Wo          , Wo          , Wo          , Wo          , Wo          , Wo          , Wo          , Wo          , Wo          , Ww          , Ww          , Ww          , Ww          , Ww          , Wo          , Gs^Fms      , Gs^Fms      , Gs^Fms      , Gs^Fp       , Ss          , Ss          , Gs^Fms      , Sm^Gvs      , Sm^Gvs      , Sm^Gvs      , Gs          , Re          , Gs          , Gs          , Ss          , Re          , Re          , Gs          , Ss^Vhs      , Ss          , Ss          
Wo          , Wo          , Wo          , Wo          , Wo          , Wo          , Wo          , Wo          , Wo          , Wo          , Ww          , Ww          , Ww          , Ww          , Ds          , Ds          , Gg          , Gs^Fp       , Gs^Fms      , Ss          , Ss          , Gs^Fms      , Gg          , Rb^Gvs      , Gs          , Gs          , Re          , Re          , Gs^Vh       , Ss          , Ss          , Gs          , Gs          , Re          , Gs          , Ss          , Ss          
Wo          , Wo          , Wo          , Wo          , Wo          , Wo          , Wo          , Wo          , Wo          , Wo          , Wo          , Wo          , Ww          , Ww          , Ds          , Ds          , Gg          , Gg          , Gs          , Ss          , Ss          , Gs          , Gs          , Gg          , Gs          , Re          , Gs          , Gs          , Gs          , Ss          , Ss          , Ss          , Gs          , Re          , Re          , Gs          , Gs          
Wo          , Wo          , Wo          , Wo          , Wo          , Wo          , Wo          , Wo          , Wo          , Wo          , Wo          , Wo          , Ww          , Ww          , Ww          , Ds          , Gg          , Gs          , Gg          , Ss          , Ss          , Ss          , Ss          , Gs          , Ww          , Re          , Ww          , Ww          , Ww          , Ss          , Gs          , Gs          , Gs          , Gs          , Re          , Re          , Re          
Wo          , Wo          , Wo          , Wo          , Wo          , Wo          , Wo          , Wo          , Wo          , Wo          , Wo          , Wo          , Wo          , Ww          , Ww          , Gg          , Gs          , Gs          , Gg          , Ss          , Ss          , Ss          , Ww          , Ww          , Wo          , Ww^Bw|      , Ww          , Wo          , Wo          , Ww          , Gs          , Gs          , Re          , Re          , Gs          , Gs          , Gs^Fms      
Wo          , Wo          , Wo          , Wo          , Wo          , Wo          , Wo          , Wo          , Wo          , Wo          , Wo          , Wo          , Wo          , Ww          , Ww          , Gg          , Gg          , Gs          , Gg          , Ss          , Ww          , Ww          , Wo          , Wo          , Ww          , Ww^Bw|      , Gg          , Ww          , Ww          , Ww          , Ww^Bw/      , Re          , Gs          , Gs          , Gs          , Gs^Fms      , Gs^Fms      
Wo          , Wo          , Wo          , Wo          , Wo          , Wo          , Wo          , Wo          , Wo          , Wo          , Wo          , Wo          , Wo          , Ww          , Ww          , Ww          , Gg          , Gs          , Gg          , Ww          , Wo          , Wo          , Ww          , Ww          , Ch          , Rr          , Ch          , Ww          , Ww^Bw/      , Ww^Bw/      , Ww          , Ww          , Ww          , Ss          , Gs          , Gs^Fms      , Gs^Fp       
Wo          , Wo          , Wo          , Wo          , Wo          , Wo          , Wo          , Wo          , Wo          , Wo          , Wo          , Wo          , Wo          , Ww          , Ww          , Ww          , Gg          , Gg^Vh       , Ww          , Ww          , Wo          , Ww          , Ds          , Gg          , Gg          , Rr          , Rr          , Rr          , Ch          , Ww          , Ww          , Wo          , Wo          , Ww          , Ww          , Ww          , Ww          
Wo          , Wo          , Wo          , Wo          , Wo          , Wo          , Wo          , Wo          , Wo          , Wo          , Wo          , Wo          , Wo          , Wo          , Wo          , Ww          , Ww          , Ww          , Wo          , Wo          , Ww          , Ww^Bw\      , Ds          , Gg          , Rp^Vhc      , Rr          , Gs^Fds      , Gg          , Gg          , Gg          , Ds          , Ww          , Ww          , Wo          , Wo          , Ww          , Ww          
Wo          , Wo          , Wo          , Wo          , Wo          , Wo          , Wo          , Wo          , Wo          , Wo          , Wo          , Wo          , Wo          , Wo          , Wo          , Wo          , Wo          , Wo          , Ww          , Ww          , Ww^Bw\      , Ds          , Rr          , Rr          , Rr          , Rr          , Gs          , Gs^Fds      , Rr^Vhc      , Gg          , Gg^Vh       , Ds          , Gs^Fds      , Ww          , Ww          , Wo          , Wo          
Wo          , Wo          , Wo          , Wo          , Wo          , Wo          , Wo          , Wo          , Wo          , Wo          , Wo          , Wo          , Wo          , Wo          , Wo          , Ww          , Ww^Bw\      , Ww          , Gg          , Ww          , Ww          , Ds          , Gs          , Rr^Vhc      , Gs          , Rr          , Rr          , Gs          , Gs          , Gg          , Gg          , Gs^Fds      , Gs^Fds      , Ww          , Ww          , Wo          , Wo          
Wo          , Wo          , Wo          , Wo          , Wo^Cov      , Wo          , Wo^Cov      , Wo          , Wo          , Wo          , Wo          , Wo          , Wo          , Wo          , Ww          , Ww          , Ds          , Ds          , Gg          , Gg          , Ww          , Ww          , Rr^Vhc      , Gs          , Rr          , Rr          , Ch          , Rr          , Rr          , Gs          , Gg^Efm      , Gg^Vh       , Ds          , Ww          , Wo          , Wo          , Wo          
Wo          , Wo          , Wo          , Wo          , Wo          , 2 Wo^Kov    , Wo          , Wo          , Wo          , Wo          , Wo          , Wo          , Wo          , Wo          , Ww          , Ww          , Ds          , Rr          , Rr          , Gg^Vh       , Gg          , Ww          , Rr          , Rr          , Rr          , Ch          , 1 Kh        , Ch          , Rr          , Gs          , Gs          , Ds          , Ww          , Ww          , Ww          , Ww          , Ww          
Wo          , Wo          , Wo          , Wo          , Wo          , Wo^Cov      , Wo          , Wo          , Wo          , Wo          , Wo          , Wo          , Wo          , Ww          , Ww          , Ww^Bw\      , Ds          , Ch          , Rr          , Rr          , Rr          , Ww^Bw/      , Rr^Vhc      , Gs          , Rr          , Ch          , Ch          , Chr         , Rr          , Rr^Vhc      , Gs          , Ds          , Ww          , Wo          , Ww          , Ww          , Ww          
Wo          , Wo          , Wo          , Wo          , Wo          , Wo          , Wo          , Wo          , Wo          , Wo          , Wo          , Wo          , Wo          , Ww          , Ww          , Ww          , Ds          , Rr          , Gg          , Gg^Vh       , Gg^Efm      , Ww          , Gs          , Gs          , Rr^Vhc      , Rr          , Rr          , Rr          , Gs^Fds      , Gs          , Ch          , Ww          , Wo          , Ww          , Gg          , Gg          , Gg          
Wo          , Wo          , Wo          , Wo          , Wo          , Wo          , Wo          , Wo          , Wo          , Wo          , Wo          , Wo          , Wo          , Ww          , Ww          , Ww^Bw/      , Ww          , Ds          , Ds          , Gg^Efm      , Ww          , Ww          , Gs^Fds      , Gs^Fds      , Gs          , Gs          , Gs          , Rr          , Rr          , Gs          , Rr          , Ww          , Ww          , Ww          , Gg          , Gg          , Gg          
Wo          , Wo          , Wo          , Wo          , Wo          , Wo          , Wo          , Wo          , Wo          , Wo          , Wo          , Wo          , Wo          , Wo          , Wo          , Ww          , Wo          , Ww^Bw/      , Ww          , Gg          , Ww          , Ww          , Ww          , Gs^Fds      , Gs          , Rr^Vhc      , Rr          , Rr          , Rr^Vh       , Rr          , Ch          , Ww^Bw\      , Ww^Bw\      , Gg          , Gg          , Gg^Vh       , Gg          
Wo          , Wo          , Wo          , Wo          , Wo          , Wo          , Wo          , Wo          , Wo          , Wo          , Wo          , Wo          , Wo          , Wo          , Wo          , Wo          , Ww          , Wo          , Wo          , Ww          , Wo          , Wo          , Ww^Bw/      , Ds          , Rr          , Rr          , Gg          , Rr          , Gg          , Gg          , Ds          , Ww          , Ww          , Re          , Re          , Gg          , Gg          
Wo          , Wo          , Wo          , Wo          , Wo          , Wo          , Wo          , Wo          , Wo          , Wo          , Wo          , Wo          , Wo          , Wo          , Ww          , Ww          , Gg          , Ww          , Ww          , Wo          , Wo          , Ww          , Ww          , Ds          , Ds          , Gg          , Ch          , Rr          , Ch          , Ds          , Ww          , Ww          , Ww          , Gg          , Re          , Re          , Re          
Wo          , Wo          , Wo          , Wo          , Wo          , Wo          , Wo          , Wo          , Wo          , Wo          , Wo          , Wo          , Wo          , Ww          , Ww          , Ww          , Gg          , Gg          , Gg          , Ww          , Wo          , Wo          , Wo          , Ww^Bw/      , Ww          , Gg          , Ww          , Ww^Bw|      , Ww          , Ww          , Ww          , Ww          , Gg          , Gg          , Re          , Gg          , Gg^Efm      
Wo          , Wo          , Wo          , Wo          , Wo          , Wo          , Wo          , Wo          , Wo          , Wo          , Wo          , Wo          , Ww          , Ww          , Gg          , Gg          , Gs^Fds      , Gg          , Gg          , Ww          , Ww          , Ww          , Ww          , Wo          , Ww          , Ww          , Ww          , Ww^Bw|      , Ww          , Ww          , Gg          , Gg          , Gg          , Gg          , Re          , Gg^Efm      , Gg          
Wo          , Wo          , Wo          , Wo          , Wo          , Wo          , Wo          , Wo          , Wo          , Wo          , Wo          , Wo          , Ww          , Ww          , Gg          , Gs^Fms      , Gs^Fms      , Gg          , Gg          , Gg          , Gg          , Gg          , Gg          , Ww          , Gg^Efm      , Ww          , Gg          , Re          , Gg          , Gg          , Re^Gvs      , Re^Gvs      , Gg          , Re          , Gg          , Gg          , Gg^Efm      
Wo          , Wo          , Wo          , Wo          , Wo          , Wo          , Wo          , Wo          , Wo          , Wo          , Wo          , Wo          , Ww          , Ww          , Gg          , Gs^Fds      , Gs^Fds      , Gg^Vh       , Re^Gvs      , Re^Gvs      , Re^Gvs      , Re^Gvs      , Re^Gvs      , Gg^Efm      , Re^Gvs      , Gg          , Gg          , Re          , Gg          , Re^Gvs      , Gg          , Gg          , Re          , Re          , Gg          , Gg          , Gg          
Wo          , Wo          , Wo          , Wo          , Wo          , Wo          , Wo          , Wo          , Wo          , Wo          , Wo          , Wo          , Wo          , Ww          , Gg          , Gg          , Re^Gvs      , Re^Gvs      , Re^Gvs      , Re^Gvs      , Re^Gvs      , Re^Gvs      , Re^Gvs      , Re^Gvs      , Re^Gvs      , Re^Gvs      , Gg          , Re          , Re          , Gg          , Re          , Re          , Gg          , Gg          , Gg          , Gs^Fms      , Gs^Fms      
