border_size=1
usage=map

Gs          , Gs          , Ds          , Wwt         , Wwt         , Wwt         , Wwt         , Wwt         , Wwt         , Wwt         , Wwt         , Wwt         
Ds          , Ds          , Wwt         , Wwt         , Wwt         , Wwt         , Wwt         , Wwrt        , Wwrt        , Wwrt        , Wwrt        , Wwt         
Wwt         , Wwt         , Wwt         , Wwt         , Wwt         , Wwt         , Wwt         , Wwrt        , Wwrt        , Wwrt        , Wwt         , Wwt         
Wwt         , Wwt         , Wwt         , Wwt         , Wwt         , Wwt         , Wwt         , Wwt         , Wwt         , Wwrt        , Wwt         , Wwt         
Wwt         , Wwt         , Wwt         , Wwt         , Wwt         , Wwt         , Mv          , Wwt         , Wwt         , Wwt         , Wwt         , Wwt         
Wwt         , Wwt         , Wwt         , Wwt         , Wwt         , Md          , Md          , Md          , Wwt         , Wwt         , Wwt         , Wwt         
Wwt         , Wwt         , Wwt         , Wwt         , Wwt         , Wwt         , Wwt         , Wwt         , Wwt         , Wwt         , Wwt         , Wwt         
Wot         , Wwt         , Wwt         , Wwt         , Wwt         , Wwt         , Wwt         , Wwt         , Wwt         , Wwt         , Wwt         , Wwt         
Wot         , Wot         , Wot         , Wwt         , Wwt         , Wwt         , Wwt         , Wwt         , Wwt         , Wwt         , Wwt         , Wwt         
Wot         , Wot         , Wot         , Wot         , Wot         , Wwt         , Wwt         , Wwt         , Wwt         , Wwt         , Wwt         , Wwt         
Wot         , Wot         , Wot         , Wot         , Wot         , Wot         , Wot         , Wwt         , Wwt         , Wwt         , 1 Wwt       , Wwt         
Wot         , Wot         , Wot         , Wot         , Wot         , Wot         , Wot         , Wot         , Wwt         , Wwt         , Wwt         , Wwt         
